111111111111111111
1000E0000000000001
10000P0C0000000001
100000001C000C0001
111111111111111111